111111111111111
1P0001000000001
111101001010001
101000001110001
1000001100C0001
100100010011001
1000C0010000001
100001000000001
111111101111111
100001000000001
111101001010001
1000000100C0001
100100010011001
1000C001B000001
1000010000000E1
111111111111111
